10 15
|-------------|
|FFF|.........|
|.............|
|FF.|.@|...P..|
|..F...|......|
|.......--....|
|....|--......|
|......F|.....|
|.............|
|-------------|